20 20 4

2 4 2 2 4 4 4 4 4 4 4 4 4 4 2 4 2 2 4 4
4 4 2 4 4 4 4 2 4 4 4 4 4 4 2 4 4 4 4 2
2 4 2 3 2 2 4 2 2 4 4 2 2 4 4 4 4 2 2 4
4 4 2 4 4 4 2 4 2 4 4 4 2 2 4 4 4 2 2 3
2 4 4 2 4 4 4 4 4 2 4 2 1 2 4 2 4 4 2 2
4 4 4 4 4 4 4 4 4 4 2 4 2 3 4 2 4 4 4 4
4 4 2 4 4 2 4 4 4 4 4 4 4 4 4 4 2 4 2 4
2 4 4 2 2 4 4 4 4 4 4 2 2 2 4 4 4 4 4 4
4 4 2 4 4 2 4 2 4 4 4 4 2 2 2 4 4 4 4 4
4 4 4 4 4 5 2 2 2 2 2 4 2 2 2 4 4 2 4 4
4 4 2 4 2 4 4 4 4 4 2 4 4 4 4 2 4 4 2 4
4 4 4 4 4 4 2 2 4 2 4 4 4 4 4 4 2 4 4 4
4 4 2 4 4 4 4 4 4 2 4 2 4 4 2 4 2 2 4 2
4 2 2 4 4 4 4 4 4 4 4 4 4 2 4 2 5 2 4 4
2 4 4 4 2 4 4 2 2 2 4 4 2 4 2 4 4 4 4 4
2 4 4 4 4 2 2 2 4 4 4 4 4 4 4 4 4 4 4 2
4 4 2 2 4 4 4 4 2 4 2 4 4 4 4 2 2 4 4 4
4 4 4 2 4 4 4 4 2 2 4 4 4 4 2 4 4 4 4 4
2 4 4 4 4 4 4 4 4 4 4 4 3 4 4 4 4 4 4 4
4 4 4 2 4 4 4 2 4 4 4 4 2 4 2 4 2 4 4 4
